####vv###
####vv###
#_o_____#
#x#_____#
#_o_____#
#_oo___##
#_#__####
#########
#########