------------------------
------------------------
------------------------
-------######-----------
-------#__v_###---------
-------#_#v__v#---------
-------#_ov_#_#---------
-------##o#_#_##--------
-------#_o_o___#--------
-------#vv_#__##--------
-------#oox#####--------
-------#___#------------
-------#####------------
------------------------
------------------------
------------------------