------------------------
------------------------
------#####-------------
------#___#-------------
------#o__#-------------
----###__o##------------
----#__o_o_#------------
--###_#_##_#---######---
--#___#_##_#####__vv#---
--#_o__o__________vv#---
--#####_###_#x##__vv#---
------#_____#########---
------#######-----------
------------------------
------------------------
------------------------