------------------------
------------------------
------------------------
-------#####------------
-------#___###----------
-------#_x___####-------
-------##o##oo__#-------
-------#_vvvv___#-------
-------#__voo_o_#-------
-------###v_#####-------
---------#__#-----------
---------####-----------
------------------------
------------------------
------------------------
------------------------