------------------------
------------------------
------------------------
------------------------
--------#######---------
--------#_vo__#---------
-------##ov#vo###-------
-------#_ov_v_ox#-------
-------#___#vo__#-------
-------#_###__###-------
-------#_____##---------
-------#######----------
------------------------
------------------------
------------------------
------------------------