------------------------
------------------------
------------------------
-------###########------
-------#____#____#------
-------#_oxooooo_#------
-------#_________#------
-------#####_#####------
----------#v__#---------
----------#v__#---------
----------#vvv#---------
----------#v__#---------
----------#####---------
------------------------
------------------------
------------------------