------------------------
------------------------
------------------------
------###########-------
------#__#__#___#-------
------#__o__#_#_#-------
------#__#__#o__#-------
------#v_#vo#__##-------
-----##_o#ov#_v#--------
-----#___#__#__#--------
-----#_#_#__o__#--------
-----#___#_x#__#--------
-----###########--------
------------------------
------------------------
------------------------
