------------------------
------------------------
------------------------
-----------#####--------
------######___##-------
------#____o_o__#-------
------#_#_###o#x#-------
------#___#__o__##------
------##vvvv_#oo_#------
-------#_#v###_#_#------
-------#__v______#------
-------##___######------
--------#####-----------
------------------------
------------------------
------------------------