------------------------
------------------------
-------########---------
-------#__##__#---------
-------#___oo_###-------
-------#__##____#-------
-------##_##_#ov#-------
--------#_##_vvv#-------
------###_###vov#-------
------#_o_###_###-------
------#____o___#--------
------###__#_x_#--------
--------########--------
------------------------
------------------------
------------------------