------------------------
------------------------
------------------------
--------#######---------
--------#__#__###-------
-------##vo#_vv_#-------
-------#_vo__oo_#-------
-------#___##_###-------
-------######___#-------
-------#_v______#-------
-------#_o_x#ov##-------
-------###__#__#--------
---------#######--------
------------------------
------------------------
------------------------